50 9
50 9 R N
50 9 R N
50 9 R N
50 8 U N
50 9 D N
50 9 R N
50 8 U N
50 8 R N
50 9 D N
50 9 R N
50 8 U N
49 8 L N
49 7 U T
48 7 L N
48 7 R N
48 6 U N
48 7 D N
49 7 R T
48 7 L N
49 7 R T
49 6 U T
50 6 R N
50 7 D H
50 6 U N
50 6 R N
50 6 D N
50 6 U N
50 6 U N
50 6 U N
50 6 D N
50 7 D H
50 6 U N
49 6 L T
50 6 R N
49 6 L T
50 6 R N
50 6 U N
49 6 L T
50 6 R N
50 6 R N
49 6 L H
50 6 R N
49 6 L T
49 7 D T
48 7 L N
47 7 L N
48 7 R T
48 6 U N
48 5 U T
47 5 L N
48 5 R N
49 5 R N
48 5 L N
48 6 D N
49 6 R T
48 6 L N
48 7 D N
48 8 D T
48 7 U N
48 6 U T
49 6 R T
49 5 U N
49 6 D H
49 6 U T
48 6 L T
48 7 D N
49 7 R T
49 8 D N
49 8 U N
49 7 U T
49 7 D T
49 7 L T
49 8 D T
50 8 R N
50 8 R N
49 8 L N
50 8 R N
50 7 U H
50 8 D N
50 8 R N
50 7 U H
50 6 U N
50 6 R N
49 6 L T
48 6 L H
48 5 U N
48 5 U N
48 5 U T
49 5 R N
48 5 L N
47 5 L N
48 5 R H
48 5 U N
48 6 D N
48 6 U N
48 6 R N
48 6 L N
48 6 L N
48 7 D N
48 7 U T
