9 11
9 12 D T
9 11 U N
8 11 L N
8 11 L N
8 11 U N
9 11 R N
10 11 R N
10 10 U N
10 10 R N
11 10 R N
11 10 D N
11 10 L N
11 9 U N
12 9 R N
12 8 U N
12 7 U N
12 8 D N
13 8 R T
13 8 U T
12 8 L N
11 8 L N
12 8 R N
11 8 L N
10 8 L T
9 8 L N
10 8 R T
10 8 U T
11 8 R H
11 7 U N
12 7 R N
12 8 D N
11 8 L N
10 8 L T
10 9 D N
11 9 R N
11 10 D N
11 9 U N
11 8 U N
11 8 D N
12 8 R T
12 8 L N
12 9 D N
11 9 L N
12 9 R N
12 8 U N
13 8 R N
14 8 R T
14 8 R T
13 8 L T
13 7 U T
13 7 U T
13 7 R T
12 7 L T
13 7 R T
12 7 L N
13 7 R T
12 7 L N
12 8 D N
13 8 R T
12 8 L N
12 9 D N
13 9 R N
14 9 R N
14 10 D H
14 10 U H
14 9 U N
14 9 R N
14 9 R N
13 9 L N
12 9 L N
12 8 U N
13 8 R T
12 8 L N
12 7 U N
12 7 U N
12 8 D N
13 8 R T
12 8 L N
12 8 D T
12 8 R N
12 8 D N
12 9 D N
12 10 D N
12 9 U N
13 9 R N
13 8 U T
13 7 U T
13 8 D H
12 8 L N
13 8 R T
13 7 U T
13 7 R T
13 6 U H
13 7 D T
14 7 R H
15 7 R H
16 7 R H
15 7 L H
15 8 D H
15 8 L H
