27 3
26 3 L N
25 3 L N
25 2 U T
26 2 R N
26 1 U N
26 1 U N
26 1 L N
27 1 R T
27 2 D T
27 1 U N
28 1 R N
29 1 R N
29 2 D N
30 2 R N
31 2 R N
32 2 R H
32 3 D N
32 3 L N
32 3 L N
32 2 U H
32 1 U N
32 2 D H
32 1 U N
31 1 L N
32 1 R N
32 2 D H
31 2 L N
31 2 D N
31 2 D N
31 1 U H
30 1 L T
31 1 R N
32 1 R T
32 1 R N
32 2 D H
33 2 R N
33 2 L N
32 2 L H
32 3 D T
32 4 D T
32 5 D N
33 5 R N
34 5 R N
35 5 R N
36 5 R T
37 5 R N
38 5 R T
37 5 L N
37 4 U N
38 4 R N
38 4 R N
38 3 U T
39 3 R N
38 3 L H
37 3 L H
36 3 L N
37 3 R H
37 2 U H
37 3 D H
38 3 R T
37 3 L H
37 2 U H
38 2 R H
37 2 L H
37 3 D H
36 3 L N
36 3 L N
36 2 U T
36 2 L T
36 3 D N
37 3 R H
37 4 D N
38 4 R N
38 5 D T
39 5 R N
39 6 D H
39 5 U H
39 5 U N
39 5 U N
39 6 D T
39 5 U N
40 5 R N
40 5 R N
39 5 L N
39 5 L T
40 5 R N
40 6 D N
40 6 U H
40 7 D N
41 7 R N
41 6 U H
42 6 R N
41 6 L H
41 5 U N
41 5 R N
41 6 D H
41 6 R H
41 7 D N
41 8 D N
41 7 U N
