45 9
46 9 R T
46 8 U N
47 8 R N
47 8 D N
47 8 D N
47 9 D T
46 9 L T
46 10 D H
46 11 D N
46 10 U H
46 11 D H
47 11 R T
47 12 D N
48 12 R T
48 11 U T
47 11 L T
48 11 R T
48 12 D N
47 12 L N
47 11 U T
47 12 D N
47 11 U T
47 12 D N
46 12 L H
46 11 U H
47 11 R T
46 11 L N
46 12 D H
46 11 U N
46 10 U H
46 11 D N
46 10 U H
45 10 L T
46 10 R H
45 10 L T
45 9 U T
45 10 D T
45 9 U T
44 9 L T
44 8 U N
44 8 U N
45 8 R N
44 8 L N
43 8 L H
44 8 R T
44 9 D N
44 10 D N
45 10 R N
45 9 U T
44 9 L N
45 9 R H
46 9 R T
46 8 U N
46 8 L N
46 7 U H
46 8 D N
46 8 L H
45 8 L N
45 9 D T
44 9 L N
45 9 R T
46 9 R T
47 9 R T
47 8 U N
48 8 R N
47 8 L N
48 8 R N
48 7 U N
48 8 D N
47 8 L N
46 8 L N
45 8 L N
44 8 L N
44 9 D N
43 9 L N
43 8 U T
43 7 U T
43 6 U N
42 6 L T
43 6 R H
44 6 R N
43 6 L N
42 6 L T
42 6 U T
42 7 D N
42 7 U T
42 6 U T
42 6 R T
41 6 L N
42 6 R N
42 6 D T
42 7 D T
42 7 D T
42 6 U T
42 7 D N
41 7 L N
40 7 L N
41 7 R N
41 7 D N
41 6 U N
