68 1
68 1 U N
68 1 U N
68 1 U N
68 1 U N
69 1 R N
69 1 U T
68 1 L N
68 2 D T
69 2 R H
68 2 L T
68 1 U N
68 2 D T
68 1 U N
68 1 L N
68 1 L N
68 1 R N
69 1 R N
69 2 D H
70 2 R T
70 3 D N
70 2 U T
70 2 D T
70 3 D N
70 2 U T
69 2 L H
69 3 D N
69 3 U N
69 3 U T
68 3 L H
69 3 R N
68 3 L H
67 3 L N
67 4 D H
67 3 U N
68 3 R H
68 4 D N
68 4 R N
68 5 D H
68 6 D T
68 5 U H
67 5 L H
66 5 L N
65 5 L H
65 4 U N
66 4 R N
67 4 R N
68 4 R N
68 5 D H
68 4 U N
69 4 R H
69 4 L H
69 3 U N
69 2 U H
69 1 U T
69 1 U N
69 2 D H
69 2 U H
68 2 L T
67 2 L H
66 2 L N
66 1 U T
66 2 D N
66 1 U N
66 1 U H
66 1 L N
66 2 D N
66 3 D N
66 2 U N
65 2 L N
65 2 U N
66 2 R N
66 1 U T
66 1 L N
66 1 R T
66 2 D N
66 3 D N
67 3 R N
67 2 U N
66 2 L N
66 3 D N
66 2 U N
66 1 U N
66 1 R H
66 2 D N
66 3 D N
66 2 U N
65 2 L N
66 2 R N
65 2 L H
65 3 D N
66 3 R H
67 3 R N
67 4 D H
67 3 U N
67 2 U N
67 2 U N
67 3 D N
67 2 U N
67 2 U N
67 3 D N
