24 6
24 6 L N
24 5 U N
24 6 D N
25 6 R N
25 5 U N
26 5 R N
26 5 D N
27 5 R T
27 5 U N
28 5 R N
28 4 U N
28 3 U H
28 2 U N
28 2 R N
28 1 U H
28 1 L T
29 1 R N
29 1 U N
28 1 L N
28 1 L T
28 1 U N
28 1 U H
28 1 U H
28 2 D N
28 3 D H
28 3 U H
28 2 U N
28 2 R N
28 3 D T
29 3 R N
29 3 U N
29 3 U N
28 3 L H
29 3 R N
30 3 R H
30 4 D T
30 5 D N
29 5 L T
29 6 D T
30 6 R N
29 6 L H
29 5 U N
29 4 U H
28 4 L N
27 4 L N
26 4 L N
26 5 D N
26 5 D N
26 5 D N
27 5 R T
26 5 L N
26 5 D N
26 5 D N
26 4 U N
26 4 L H
26 4 R N
26 4 D N
26 4 L N
26 5 D N
25 5 L N
26 5 R N
26 5 U N
27 5 R T
26 5 L N
26 5 D N
26 5 D N
26 5 D N
25 5 L N
25 5 L N
25 5 U T
25 5 D N
24 5 L N
25 5 R H
25 5 U N
25 6 D N
25 7 D N
24 7 L N
23 7 L H
23 7 U H
23 7 U H
24 7 R N
23 7 L H
23 7 U H
23 8 D T
23 8 D T
24 8 R H
24 9 D H
25 9 R N
25 9 D N
25 10 D N
24 10 L N
23 10 L N
24 10 R N
24 9 U H
25 9 R N
25 8 U N
25 9 D N
24 9 L H
24 10 D N
24 9 U H
