78 13
79 13 R T
79 13 L N
80 13 R N
80 14 D H
79 14 L N
78 14 L N
79 14 R T
79 14 D N
80 14 R H
79 14 L N
79 13 U T
78 13 L H
79 13 R T
80 13 R N
80 13 L N
80 12 U T
80 12 D T
79 12 L H
80 12 R T
81 12 R N
80 12 L T
81 12 R N
81 11 U N
81 11 U N
82 11 R T
82 10 U N
82 10 R N
82 9 U H
82 8 U T
81 8 L N
81 9 D H
81 9 D T
82 9 R H
82 8 U T
81 8 L T
81 8 R T
81 7 U H
81 6 U H
82 6 R N
81 6 L H
81 6 L H
80 6 L N
79 6 L T
79 6 U T
79 6 L T
78 6 L T
79 6 R T
79 7 D N
79 7 D N
80 7 R T
79 7 L N
80 7 R H
80 6 U H
79 6 L H
79 5 U N
80 5 R N
80 5 L N
79 5 L N
79 5 L T
80 5 R N
80 4 U T
79 4 L T
79 4 L T
79 4 L T
79 5 D H
78 5 L H
78 6 D H
77 6 L T
77 7 D T
77 7 R T
77 8 D H
77 7 U T
77 7 R T
77 6 U T
77 6 L N
78 6 R T
78 6 D T
78 6 D N
79 6 R T
79 6 D T
79 7 D N
79 7 L N
79 8 D N
80 8 R H
80 9 D N
79 9 L N
78 9 L N
78 8 U T
78 8 U T
77 8 L N
77 8 U H
76 8 L H
76 9 D H
76 10 D N
76 10 D N
75 10 L N
76 10 R N
76 10 R N
76 9 U H
76 8 U H
