55 7
55 6 U N
55 6 L N
55 5 U H
56 5 R N
57 5 R T
57 5 R T
57 4 U N
56 4 L N
56 3 U N
56 4 D N
56 5 D N
56 5 R N
56 6 D H
56 5 U T
56 6 D H
55 6 L N
55 5 U H
55 6 D N
55 7 D N
55 8 D H
55 7 U N
56 7 R N
56 7 D N
56 8 D T
56 7 U N
56 6 U H
55 6 L N
56 6 R H
57 6 R N
56 6 L H
56 7 D N
56 8 D T
57 8 R H
57 7 U N
57 6 U N
57 5 U T
57 5 R T
57 6 D H
57 7 D N
58 7 R N
59 7 R N
59 7 R N
59 7 R N
59 8 D T
58 8 L T
58 7 U N
57 7 L N
57 7 U N
58 7 R N
57 7 L N
57 8 D H
57 7 U N
56 7 L N
56 7 D N
56 7 D N
57 7 R N
57 6 U N
56 6 L H
56 7 D N
55 7 L N
55 8 D H
55 9 D H
55 9 L H
55 10 D H
55 11 D N
55 12 D H
56 12 R N
55 12 L H
56 12 R N
57 12 R N
57 13 D N
58 13 R N
57 13 L H
57 12 U N
57 11 U H
57 12 D N
57 13 D N
57 13 D N
58 13 R N
59 13 R H
58 13 L N
58 14 D H
58 15 D T
59 15 R H
58 15 L T
58 15 D T
58 14 U N
58 13 U N
58 14 D H
58 13 U N
58 13 D N
59 13 R H
59 13 U H
60 13 R N
60 13 R N
60 12 U T
61 12 R N
60 12 L T
59 12 L H
58 12 L H
