35 5
35 4 U T
36 4 R N
35 4 L T
35 3 U N
35 4 D T
35 3 U N
35 3 U N
35 3 U N
34 3 L H
34 4 D N
34 5 D N
35 5 R N
35 5 D N
35 4 U T
36 4 R N
36 4 R N
36 5 D H
36 4 U N
35 4 L T
35 4 R T
34 4 L N
34 3 U H
34 3 U H
34 4 D N
35 4 R T
34 4 L N
34 3 U H
33 3 L H
34 3 R H
33 3 L H
33 2 U N
33 3 D H
34 3 R H
33 3 L H
33 4 D T
33 5 D N
33 4 U T
33 3 U H
34 3 R H
33 3 L H
32 3 L N
32 3 R N
33 3 R H
33 2 U T
33 3 D H
32 3 L N
32 3 D N
31 3 L H
32 3 R N
33 3 R H
34 3 R T
34 3 D H
34 3 U H
34 4 D N
34 3 U N
33 3 L H
32 3 L N
31 3 L H
31 2 U T
31 1 U T
31 1 U T
31 1 L T
31 1 U T
31 2 D N
30 2 L N
30 2 L N
30 2 D N
30 1 U N
30 1 U N
30 2 D N
31 2 R N
32 2 R N
32 1 U N
32 1 U N
33 1 R N
34 1 R H
34 1 D H
33 1 L N
33 2 D N
32 2 L N
32 3 D N
32 4 D H
32 5 D N
33 5 R N
33 5 U N
33 6 D T
32 6 L H
32 5 U H
31 5 L N
31 6 D T
32 6 R H
31 6 L T
30 6 L N
29 6 L N
29 6 D N
29 5 U T
29 6 D N
29 7 D N
29 6 U N
30 6 R N
