53 4
54 4 R T
54 4 U T
54 5 D N
54 4 U T
53 4 L N
53 3 U H
53 3 U N
53 4 D N
52 4 L N
52 5 D H
52 5 D H
52 5 D H
52 4 U N
51 4 L N
51 5 D T
50 5 L H
50 5 L H
50 5 R H
51 5 R T
51 4 U N
51 3 U T
51 3 U T
50 3 L H
51 3 R T
51 4 D N
51 3 U T
52 3 R N
51 3 L H
50 3 L H
50 2 U N
50 1 U T
50 2 D N
49 2 L N
49 1 U H
50 1 R T
50 1 U T
50 1 U T
49 1 L N
49 2 D N
49 1 U N
50 1 R T
50 1 U T
49 1 L N
48 1 L N
48 1 U N
48 2 D N
48 3 D N
47 3 L N
47 3 L N
48 3 R N
49 3 R T
50 3 R H
50 4 D N
49 4 L N
49 4 D N
49 3 U T
50 3 R H
50 3 R H
50 2 U N
50 3 D H
50 4 D N
50 5 D H
50 6 D N
51 6 R N
51 6 R N
51 6 R N
51 5 U T
51 4 U N
51 4 L N
51 5 D N
51 4 U T
50 4 L N
50 5 D H
50 4 U N
51 4 R N
51 3 U T
52 3 R N
52 3 R N
52 4 D N
51 4 L N
51 5 D T
50 5 L H
50 6 D N
49 6 L H
49 7 D N
50 7 R T
50 8 D N
49 8 L T
49 7 U N
50 7 R T
50 7 R T
50 7 R H
49 7 L N
49 8 D T
49 8 U T
50 8 R N
49 8 L T
48 8 L N
47 8 L N
46 8 L N
