56 9
56 9 U T
55 9 L N
54 9 L N
54 9 R N
54 8 U T
54 8 U N
55 8 R N
55 8 U N
55 8 U N
54 8 L T
53 8 L N
53 9 D N
52 9 L T
51 9 L N
50 9 L T
51 9 R H
52 9 R T
53 9 R H
53 8 U N
53 8 D H
53 7 U N
53 8 D N
53 7 U T
53 8 D N
53 8 D N
53 7 U N
53 6 U N
54 6 R N
53 6 L N
53 7 D N
52 7 L H
52 6 U H
52 7 D H
52 6 U N
52 5 U N
51 5 L H
51 4 U H
51 5 D H
51 4 U H
51 4 L H
51 4 L H
51 3 U T
52 3 R N
53 3 R N
53 3 L N
53 3 D N
52 3 L N
53 3 R H
52 3 L N
52 4 D N
52 3 U N
52 2 U T
52 2 D T
53 2 R H
53 2 R H
53 3 D N
53 2 U H
53 2 U H
53 2 U H
54 2 R T
53 2 L H
54 2 R T
54 1 U N
54 1 U N
54 2 D T
55 2 R N
54 2 L T
54 2 D T
54 1 U H
54 1 L N
54 1 R N
54 1 U N
54 1 U N
55 1 R H
54 1 L H
54 1 L N
54 1 U N
54 2 D T
54 1 U N
54 1 U N
54 1 U N
54 1 U N
55 1 R H
55 1 R H
55 1 R H
55 1 U H
55 2 D T
55 1 U H
55 1 U H
55 2 D N
56 2 R N
57 2 R H
57 2 U H
57 3 D N
57 3 D N
58 3 R T
57 3 L N
57 2 U H
56 2 L N
57 2 R H
