90 7
90 6 U H
89 6 L T
89 6 D T
89 5 U N
90 5 R N
91 5 R N
91 5 D N
92 5 R H
91 5 L N
92 5 R H
91 5 L N
91 4 U T
92 4 R N
91 4 L T
91 3 U N
92 3 R T
91 3 L N
91 4 D T
91 4 U T
91 5 D N
91 4 U T
90 4 L N
90 5 D T
91 5 R N
91 4 U T
91 3 U T
91 2 U T
92 2 R T
92 3 D T
92 4 D N
92 3 U T
91 3 L N
92 3 R T
92 2 U T
91 2 L T
91 1 U T
91 2 D T
91 3 D T
90 3 L T
89 3 L N
89 3 L N
89 2 U T
88 2 L H
89 2 R N
88 2 L T
88 1 U N
89 1 R H
89 1 D H
90 1 R N
90 1 U H
90 2 D T
89 2 L N
89 3 D N
89 4 D T
90 4 R N
90 3 U T
89 3 L N
90 3 R T
91 3 R N
92 3 R T
92 2 U T
92 2 R T
92 2 L T
92 2 R T
92 3 D T
92 2 U T
92 1 U N
92 1 R H
92 1 U H
92 1 U H
92 1 U H
92 2 D T
92 1 U H
92 1 U H
91 1 L N
91 2 D T
90 2 L T
90 2 R T
89 2 L N
88 2 L H
89 2 R N
88 2 L H
89 2 R N
89 1 U H
90 1 R N
90 1 U N
90 1 R N
90 1 U N
89 1 L H
89 2 D T
90 2 R T
90 1 U N
90 1 U N
90 1 L N
90 2 D T
91 2 R T
91 2 L T
91 3 D N
92 3 R T
92 3 U T
