40 6
40 5 U T
40 5 D T
41 5 R N
42 5 R N
42 4 U H
41 4 L N
41 3 U H
42 3 R T
42 4 D H
42 3 U T
42 4 D H
41 4 L N
41 3 U N
41 2 U N
41 2 R N
41 3 D N
42 3 R H
41 3 L H
40 3 L N
40 3 D N
40 2 U N
40 1 U N
40 1 D N
40 2 D N
40 3 D N
39 3 L H
39 2 U N
40 2 R N
39 2 L H
39 1 U N
39 1 U N
40 1 R N
41 1 R N
40 1 L N
40 2 D N
41 2 R H
41 2 U N
42 2 R T
42 2 L T
42 1 U H
42 1 R H
42 1 U N
42 1 U H
42 2 D T
41 2 L N
41 3 D N
40 3 L N
40 2 U N
40 2 R N
40 2 R N
40 3 D N
39 3 L H
39 2 U H
38 2 L N
39 2 R H
40 2 R N
39 2 L N
40 2 R N
40 1 U N
40 2 D N
41 2 R N
41 3 D H
40 3 L N
40 4 D N
39 4 L H
39 4 D T
39 5 D N
39 4 U H
39 5 D N
38 5 L N
39 5 R N
39 6 D H
39 7 D N
39 6 U H
40 6 R H
39 6 L H
39 7 D N
38 7 L N
37 7 L T
37 6 U T
37 7 D T
37 8 D N
37 8 D N
37 7 U T
37 8 D N
37 8 L N
37 9 D N
38 9 R T
39 9 R N
39 9 U N
40 9 R N
39 9 L H
39 8 U T
39 8 U T
39 9 D N
40 9 R N
41 9 R N
41 10 D T
42 10 R H
42 11 D H
